999 999 999 999 999 999 999 999 999 999 999 999 999 999 999 999 999 999 999 999 999 999 999 999 999 999 999 999 999 999 999 999 999 999 999 999 999 999 999 999 999 999 999 999 999 999 999 999 999 999 999 999 999 999 999 999 999 999 999 999 999 999 999 999 999 999 999 999 999 999
999 999 999 999 999 999 999 999 999 999 999 999 999 999 999 999 999 999 999 999 999 999 999 999 999 999 999 999 999 999 999 999 999 999 999 999 999 999 999 999 999 999 999 999 999 999 999 999 999 999 999 999 999 999 999 999 999 999 999 999 999 999 999 999 999 999 999 999 999 999
999 999 999 999 999 999 999 999 999 999 999 999 999 999 999 999 999 999 999 999 999 999 999 999 999 999 999 999 999 999 999 999 999 999 999 999 999 999 999 999 999 999 999 999 999 999 999 999 999 999 999 999 999 999 999 999 999 999 999 999 999 999 999 999 999 999 999 999 999 999
999 999 999 999 999 999 999 999 999 999 999 999 999 999 999 999 999 999 999 999 999 999 999 999 999 999 999 999 999 999 999 999 999 999 999 999 999 999 999 999 999 999 999 999 999 999 999 999 999 999 999 999 999 999 999 999 999 999 999 999 999 999 999 999 999 999 999 999 999 999
999 999 999 999 999 999 999 999 999 999 999 999 999 999 999 999 999 999 999 999 999 999 999 999 999 999 999 999 999 999 999 999 999 999 999 999 999 999 999 999 999 999 999 999 999 999 999 999 999 999 999 999 999 999 999 999 999 999 999 999 999 999 999 999 999 999 999 999 999 999
999 999 999 999 999 999 999 999 999 999 999 999 999 999 999 999 999 999 999 999 999 999 999 999 999 999 999 999 999 999 999 999 999 999 999 999 999 999 999 999 999 999 999 999 999 999 999 999 999 999 999 999 999 999 999 999 999 999 999 999 999 999 999 999 999 999 999 999 999 999
999 999 999 999 999 999 999 999 999 999 999 999 999 999 999 999 999 999 999 999 999 999 999 999 999 999 999 999 999 999 999 999 999 999 999 999 999 999 999 999 999 999 999 999 999 999 999 999 999 999 999 999 999 999 999 999 999 999 999 999 999 999 999 999 999 999 999 999 999 999
999 999 999 999 999 999 999 999 999 999 999 999 999 999 999 999 999 999 999 999 999 999 999 999 999 999 999 999 999 999 999 999 999 999 999 999 999 999 999 999 999 999 999 999 999 999 999 999 999 999 999 999 999 999 999 999 999 999 999 999 999 999 999 999 999 999 999 999 999 999
999 999 999 999 999 999 999 999 999 999 999 999 999 999 999 999 999 999 999 999 999 999 999 999 999 999 999 999 999 999 999 999 999 999 999 999 999 999 999 999 999 999 999 999 999 999 999 999 999 999 999 999 999 999 999 999 999 999 999 999 999 999 999 999 999 999 999 999 999 999
999 999 999 999 999 999 999 999 999 999 999 999 999 999 999 999 999 999 999 999 999 999 999 999 999 999 999 999 999 999 999 999 999 999 999 999 999 999 999 999 999 999 999 999 999 999 999 999 999 999 999 999 999 999 999 999 999 999 999 999 999 999 999 999 999 999 999 999 999 999
999 999 999 999 999 999 999 999 999 999 999 999 999 999 999 999 999 999 999 999 999 999 999 999 999 999 999 999 999 999 999 999 999 999 999 999 999 999 999 999 999 999 999 999 999 999 999 999 999 999 999 999 999 999 999 999 999 999 999 999 999 999 999 999 999 999 999 999 999 999
999 999 999 999 999 999 999 999 999 999 999 996 999 999 999 999 999 999 999 501 505 505 505 505 505 505 505 502 999 999 999 999 999 999 999 999 999 996 999 999 999 999 999 999 999 999 999 999 999 999 999 999 999 999 999 999 999 999 999 999 999 999 999 999 999 999 999 999 999 999
999 999 999 999 999 999 999 999 999 999 999 999 999 999 501 505 505 505 505 509 500 500 500 636 500 500 636 506 999 999 999 999 999 999 999 998 999 999 999 999 999 999 999 999 999 999 999 999 999 999 999 999 999 999 999 996 999 999 999 999 999 999 999 999 999 999 999 999 999 999
999 999 999 999 999 999 999 999 999 999 999 999 999 998 507 635 500 500 500 500 500 500 500 500 500 500 500 506 999 999 999 999 999 999 999 999 999 999 999 999 999 999 999 999 999 999 999 999 999 999 999 999 999 999 999 999 999 999 999 999 999 999 999 999 999 999 999 999 999 999
999 999 999 999 999 999 999 999 999 999 999 999 501 505 509 500 500 652 505 505 505 505 505 505 505 505 653 510 505 505 502 999 999 501 505 505 505 654 505 505 505 505 505 505 505 505 505 505 505 505 505 505 505 502 999 999 999 999 998 999 999 999 999 999 999 999 999 999 999 999
999 999 999 999 999 999 999 999 999 999 999 999 507 500 500 500 635 648 500 635 500 500 500 636 500 500 649 657 657 657 659 999 999 507 500 500 640 649 500 500 500 500 640 500 500 500 500 500 500 639 500 500 657 510 502 999 999 999 999 999 999 999 999 999 999 999 999 999 999 999
999 999 999 999 999 999 999 999 999 999 999 501 509 500 500 500 657 648 500 500 500 500 500 500 500 500 478 479 479 479 480 630 630 629 500 500 500 649 500 500 626 627 627 627 627 627 627 627 627 627 616 500 500 500 506 999 999 999 999 999 999 999 999 999 999 999 999 999 999 999
999 999 999 999 999 999 999 999 999 999 999 507 500 652 505 505 505 509 500 500 500 500 500 500 657 635 649 657 657 657 659 999 999 507 500 500 500 649 500 639 603 605 605 605 604 604 605 604 605 606 617 500 639 500 506 999 999 999 999 999 999 999 999 999 999 999 999 999 999 999
999 999 999 999 999 999 999 999 999 999 999 507 500 648 500 500 500 500 500 500 500 656 643 643 643 643 650 500 500 500 506 999 999 507 500 500 500 649 500 500 612 600 600 600 600 600 600 600 600 607 617 500 500 500 506 999 999 999 999 999 999 999 999 999 999 999 999 999 999 999
999 999 999 999 999 999 999 999 999 999 999 507 500 648 500 636 500 500 500 500 657 649 657 500 500 500 500 511 508 508 504 999 999 507 500 640 500 649 500 500 612 600 600 600 600 600 600 600 600 607 617 500 500 500 506 999 999 999 999 999 999 999 999 999 999 999 999 999 999 999
999 999 999 999 999 999 999 999 999 999 999 507 500 648 500 500 500 500 500 500 636 649 500 636 511 508 508 504 999 999 999 999 999 507 500 500 500 649 500 500 612 600 600 600 600 600 600 600 600 607 617 500 500 500 506 999 999 999 999 999 999 999 999 999 999 999 999 999 999 999
999 999 999 999 999 999 999 999 999 999 999 507 636 651 643 644 645 643 643 643 643 650 500 500 506 999 999 999 999 999 999 999 999 507 500 500 500 649 500 500 612 600 600 600 600 600 600 600 600 607 617 640 500 500 506 999 999 999 999 999 999 999 999 999 999 999 999 999 999 999
999 999 999 999 999 999 999 999 999 999 999 507 500 500 500 646 647 500 500 500 500 500 500 635 506 999 996 999 999 999 999 999 501 509 500 500 500 649 640 500 612 600 600 600 600 600 600 600 600 607 617 500 500 500 506 999 999 999 999 999 999 999 999 999 999 999 999 999 999 999
999 999 999 999 999 999 999 999 999 999 999 507 500 500 500 500 500 500 500 500 500 511 508 508 504 999 999 998 999 999 999 501 509 500 500 500 500 649 500 500 612 600 600 600 600 600 600 600 600 607 617 500 500 500 506 999 999 999 999 999 999 999 999 999 999 999 999 999 999 999
999 999 999 999 999 999 999 999 999 999 999 507 500 500 500 500 500 635 500 500 636 506 999 999 999 999 999 999 999 999 999 507 639 500 500 500 657 649 500 500 612 600 600 600 600 600 600 600 600 607 617 500 639 500 506 999 999 999 999 999 999 999 999 999 999 999 999 999 999 999
999 999 999 999 999 999 999 999 999 999 999 507 657 500 500 500 500 500 500 500 500 506 999 999 999 999 999 501 505 505 505 651 643 644 645 643 643 650 500 500 612 600 600 600 600 600 600 600 600 607 617 500 500 500 506 999 999 999 999 999 999 999 999 999 999 999 999 999 999 999
999 999 999 999 999 999 999 999 999 999 999 503 508 508 508 632 508 508 508 508 508 504 999 999 501 505 505 509 500 500 500 500 657 646 647 657 500 500 500 500 611 609 609 610 610 609 609 609 609 608 617 500 500 500 506 999 999 999 999 999 999 999 999 999 999 999 999 999 999 999
999 999 999 999 999 999 999 999 999 999 999 999 999 999 999 633 999 999 999 999 999 999 999 999 507 614 627 627 627 627 616 500 500 500 500 500 500 500 639 493 495 495 495 495 495 495 495 495 495 494 617 500 500 500 506 999 999 999 999 999 999 999 999 999 999 999 999 999 999 999
999 999 999 999 999 999 999 999 999 999 999 999 999 999 999 633 999 999 999 999 501 505 505 505 509 617 500 489 488 487 617 500 500 500 500 500 500 500 500 498 603 605 604 604 605 605 604 605 605 606 617 500 500 500 506 999 999 999 999 999 999 999 999 999 999 999 999 999 999 999
999 999 999 999 999 999 999 999 999 999 999 999 999 999 999 633 999 999 999 999 507 614 627 627 627 624 500 486 485 484 617 311 316 301 301 301 315 312 500 498 612 600 600 600 600 600 600 600 600 607 617 500 500 500 506 999 999 999 999 999 999 999 999 999 999 999 999 999 999 999
999 999 999 999 999 999 999 999 999 999 999 999 999 999 994 633 999 999 998 999 507 617 639 500 500 500 500 483 482 481 617 303 321 318 300 323 327 304 500 498 612 600 600 600 600 600 600 600 600 607 617 500 500 500 506 999 999 999 999 999 999 999 999 999 999 999 999 999 999 999
999 999 999 999 999 999 999 999 999 999 999 999 999 999 999 633 999 999 999 999 507 617 500 500 500 640 500 500 500 500 617 303 322 300 300 300 328 304 500 498 612 600 600 600 600 600 600 600 600 607 617 500 500 500 506 999 999 999 999 999 999 999 999 999 999 999 999 999 999 999
999 999 999 999 999 999 999 999 999 999 999 999 999 501 505 634 502 995 999 999 507 617 500 500 500 500 500 500 500 500 617 303 300 300 300 300 300 304 500 498 612 600 600 600 600 600 600 600 600 607 617 500 640 500 506 999 999 999 999 999 999 999 999 999 999 999 999 999 999 999
999 999 999 999 999 999 999 999 999 999 999 999 501 509 500 500 510 502 999 999 507 622 627 627 627 616 500 500 500 500 617 303 300 300 324 300 300 304 500 498 612 600 600 600 600 600 600 600 600 607 617 500 500 500 506 999 999 999 999 999 999 999 999 999 999 999 999 999 999 999
999 999 999 999 999 999 999 999 999 999 999 996 507 500 639 500 640 506 999 999 503 508 508 508 512 622 627 627 627 627 624 307 301 301 299 302 301 308 500 498 612 600 600 600 600 600 600 600 600 607 617 500 500 500 506 999 999 999 999 999 999 999 999 999 999 999 999 999 999 999
999 999 999 999 999 999 999 999 999 999 999 999 507 500 500 500 500 506 999 999 994 999 999 999 507 500 500 639 500 500 500 500 500 657 498 657 500 500 500 498 612 600 600 600 600 600 600 600 600 607 617 500 500 500 506 999 999 999 999 999 999 999 999 999 999 999 999 999 999 999
999 999 999 999 999 999 999 999 999 999 999 999 507 500 500 500 500 631 630 630 630 630 630 630 629 500 500 500 500 500 640 500 500 500 498 500 500 500 640 498 612 600 600 600 600 600 600 600 600 607 617 500 500 500 506 999 999 999 999 999 999 999 999 999 999 999 999 999 999 999
999 999 999 999 999 999 999 999 999 999 999 999 507 639 500 500 639 506 995 999 999 999 999 999 507 500 500 500 500 500 500 500 500 500 492 495 495 495 495 491 611 610 610 609 609 610 610 609 610 608 617 500 500 500 506 999 999 999 999 999 999 999 999 999 999 999 999 999 999 999
999 999 999 999 999 999 999 999 999 999 999 999 503 512 500 500 511 504 999 999 999 501 505 505 509 614 627 627 627 627 627 616 500 500 500 500 500 500 500 500 626 627 627 627 627 627 627 627 627 627 624 500 500 500 506 999 999 999 999 999 999 999 999 999 999 999 999 999 999 999
999 999 999 999 999 999 999 999 999 999 999 999 994 503 508 632 504 999 999 999 999 507 614 627 627 624 500 500 500 500 500 617 500 500 500 500 500 500 500 500 500 500 500 500 500 500 500 500 500 500 500 500 500 500 506 999 999 999 999 999 999 999 999 999 999 999 999 999 999 999
999 999 999 999 999 999 999 999 999 999 999 999 999 999 999 633 999 999 999 999 999 507 617 500 640 500 500 500 500 500 500 617 500 639 500 500 500 500 500 500 500 500 500 500 500 500 500 500 500 639 500 500 500 500 506 999 999 999 999 999 999 999 999 999 999 999 999 999 999 999
999 999 999 999 999 999 999 999 999 999 999 999 999 999 999 633 999 999 999 999 999 507 617 500 500 500 500 500 500 500 639 617 500 500 500 500 500 500 500 500 639 500 500 500 500 500 500 500 500 500 500 500 500 500 506 999 999 999 999 999 999 999 999 999 999 999 999 999 999 999
999 999 999 999 999 999 999 999 999 999 999 999 999 999 999 633 999 999 999 999 999 507 622 627 627 627 627 627 627 627 627 624 500 500 500 500 500 500 500 500 500 500 500 500 500 640 500 500 500 500 500 500 500 657 506 999 999 999 999 999 999 999 999 999 999 999 999 999 999 999
999 999 999 999 999 999 999 999 999 999 999 999 501 655 505 634 505 505 654 502 999 503 508 508 508 508 508 508 508 508 508 508 508 508 632 508 508 508 512 500 500 500 500 500 500 500 500 500 511 508 508 508 508 508 504 999 999 999 999 999 999 999 999 999 999 999 999 999 999 999
999 999 999 999 999 999 999 999 999 999 999 999 507 648 638 500 500 500 649 510 502 999 999 999 999 999 999 999 999 999 999 999 999 999 633 999 999 999 503 508 508 508 508 508 508 508 508 508 504 999 999 999 999 999 999 999 999 996 999 999 999 999 999 999 999 999 999 999 999 999
999 999 999 999 999 999 999 999 999 999 999 999 507 648 500 500 500 500 649 657 510 505 502 999 999 999 996 999 999 994 999 995 999 999 633 999 999 994 999 999 999 999 999 999 999 999 999 999 999 999 999 999 999 999 999 999 999 999 998 999 999 999 999 999 999 999 999 999 999 999
999 999 999 999 999 999 999 999 999 999 999 999 507 648 500 500 500 500 510 505 653 638 506 999 999 999 999 998 999 999 999 999 501 505 634 505 502 999 994 999 999 999 999 999 999 999 999 999 999 999 999 501 505 505 505 505 502 999 999 999 999 999 999 999 999 999 999 999 999 999
999 999 999 999 999 999 999 999 999 999 999 999 507 648 500 500 500 500 637 500 649 500 510 505 505 505 502 999 999 999 999 501 509 500 500 639 510 502 999 995 999 999 999 999 996 999 999 999 999 999 999 507 638 500 500 657 510 505 502 999 999 999 999 999 999 999 999 999 999 999
999 999 999 999 999 999 999 999 999 999 999 999 507 648 500 500 500 500 500 500 649 500 500 637 500 657 506 999 999 994 999 507 500 640 500 500 500 506 999 999 999 999 999 999 999 999 999 999 999 999 999 507 500 500 500 500 500 657 506 999 999 999 999 999 999 999 999 999 999 999
999 999 999 999 999 999 999 999 999 999 999 999 507 648 657 500 500 500 500 500 649 500 500 500 500 500 510 505 502 999 999 503 508 508 632 508 508 504 999 999 999 999 999 999 999 999 501 505 505 505 505 648 500 500 500 500 500 500 506 999 999 999 999 999 999 999 999 999 999 999
999 999 999 999 999 999 999 999 999 999 999 999 507 651 643 643 643 644 645 643 650 500 500 500 500 500 500 657 506 999 999 999 999 999 633 999 999 999 999 999 999 999 999 999 999 501 509 637 500 500 657 648 500 500 656 643 643 643 642 999 999 999 999 999 999 999 999 999 999 999
999 999 999 999 999 999 999 999 999 999 999 999 507 657 638 500 500 646 647 500 500 500 500 637 500 500 500 500 506 999 999 501 505 505 634 505 505 502 999 999 999 999 999 999 999 507 500 500 500 500 500 648 500 500 649 511 508 508 504 999 999 999 999 999 999 999 999 999 999 999
999 999 999 999 999 999 999 999 999 999 999 999 503 508 512 637 500 500 500 500 500 500 500 500 500 638 500 500 510 505 505 509 638 500 500 500 637 506 999 999 999 999 999 999 998 507 638 500 500 500 500 651 644 645 650 506 999 999 999 999 999 999 999 999 999 999 999 999 999 999
999 999 999 999 999 999 999 999 999 999 999 999 999 996 507 500 500 500 500 500 500 500 500 500 500 500 500 500 500 500 638 500 500 500 500 500 500 510 505 505 505 505 505 505 505 648 500 500 500 500 500 500 646 647 500 506 999 999 999 999 999 999 999 999 999 999 999 999 999 999
999 999 999 999 999 999 999 999 999 999 999 999 998 999 507 500 500 500 500 500 500 500 500 638 500 500 500 500 500 500 500 500 500 500 500 500 500 500 500 638 500 500 500 637 500 648 500 500 500 500 500 656 643 643 643 642 999 999 999 999 999 999 999 999 999 999 999 999 999 999
999 999 999 999 999 999 999 999 999 999 999 999 999 999 503 508 508 512 500 638 500 500 500 500 500 500 500 500 638 500 500 500 500 500 500 500 500 637 500 500 500 500 500 500 500 651 643 644 645 643 643 650 657 500 638 506 999 999 999 999 999 999 999 999 999 999 999 999 999 999
999 999 999 999 999 999 999 999 999 999 999 999 999 999 999 999 999 507 657 500 500 500 500 500 500 637 500 500 500 500 500 500 500 500 500 500 500 500 500 500 500 500 500 500 500 500 500 646 647 500 500 511 508 508 508 504 999 999 999 999 999 999 999 999 999 999 999 999 999 999
999 999 999 999 999 999 999 999 999 999 999 999 996 999 999 999 999 503 508 508 508 512 657 500 500 500 500 657 500 500 637 500 500 500 500 500 638 500 500 500 638 500 500 500 500 638 500 500 500 511 508 504 999 999 999 999 996 999 999 999 999 999 999 999 999 999 999 999 999 999
999 999 999 999 999 999 999 999 999 999 999 999 999 999 999 999 999 999 999 999 999 503 508 508 508 508 508 508 508 508 508 508 508 508 508 508 508 508 508 508 508 508 508 508 508 508 508 508 508 504 999 999 999 999 999 999 999 999 999 999 999 999 999 999 999 999 999 999 999 999
999 999 999 999 999 999 999 999 999 999 999 999 999 999 999 999 999 999 999 999 999 999 999 999 999 999 999 999 999 999 999 999 999 999 999 999 999 999 999 999 999 999 999 999 999 999 999 999 999 999 999 999 999 999 999 999 998 999 999 999 999 999 999 999 999 999 999 999 999 999
999 999 999 999 999 999 999 999 999 999 999 999 999 999 999 999 999 999 999 999 999 999 999 999 999 999 999 999 999 999 999 999 999 999 999 999 999 999 999 999 999 999 999 999 999 999 999 999 999 999 999 999 999 999 999 999 999 999 999 999 999 999 999 999 999 999 999 999 999 999
999 999 999 999 999 999 999 999 999 999 999 999 999 999 999 999 999 999 999 999 999 999 999 999 999 999 999 999 999 999 999 999 999 999 999 999 999 999 999 999 999 999 999 999 999 999 999 999 999 999 999 999 999 999 999 999 999 999 999 999 999 999 999 999 999 999 999 999 999 999
999 999 999 999 999 999 999 999 999 999 999 999 999 999 999 999 999 999 999 999 999 999 999 999 999 999 999 999 999 999 999 999 999 999 999 999 999 999 999 999 999 999 999 999 999 999 999 999 999 999 999 999 999 999 999 999 999 999 999 999 999 999 999 999 999 999 999 999 999 999
999 999 999 999 999 999 999 999 999 999 999 999 999 999 999 999 999 999 999 999 999 999 999 999 999 999 999 999 999 999 999 999 999 999 999 999 999 999 999 999 999 999 999 999 999 999 999 999 999 999 999 999 999 999 999 999 999 999 999 999 999 999 999 999 999 999 999 999 999 999
999 999 999 999 999 999 999 999 999 999 999 999 999 999 999 999 999 999 999 999 999 999 999 999 999 999 999 999 999 999 999 999 999 999 999 999 999 999 999 999 999 999 999 999 999 999 999 999 999 999 999 999 999 999 999 999 999 999 999 999 999 999 999 999 999 999 999 999 999 999
999 999 999 999 999 999 999 999 999 999 999 999 999 999 999 999 999 999 999 999 999 999 999 999 999 999 999 999 999 999 999 999 999 999 999 999 999 999 999 999 999 999 999 999 999 999 999 999 999 999 999 999 999 999 999 999 999 999 999 999 999 999 999 999 999 999 999 999 999 999
999 999 999 999 999 999 999 999 999 999 999 999 999 999 999 999 999 999 999 999 999 999 999 999 999 999 999 999 999 999 999 999 999 999 999 999 999 999 999 999 999 999 999 999 999 999 999 999 999 999 999 999 999 999 999 999 999 999 999 999 999 999 999 999 999 999 999 999 999 999
999 999 999 999 999 999 999 999 999 999 999 999 999 999 999 999 999 999 999 999 999 999 999 999 999 999 999 999 999 999 999 999 999 999 999 999 999 999 999 999 999 999 999 999 999 999 999 999 999 999 999 999 999 999 999 999 999 999 999 999 999 999 999 999 999 999 999 999 999 999
999 999 999 999 999 999 999 999 999 999 999 999 999 999 999 999 999 999 999 999 999 999 999 999 999 999 999 999 999 999 999 999 999 999 999 999 999 999 999 999 999 999 999 999 999 999 999 999 999 999 999 999 999 999 999 999 999 999 999 999 999 999 999 999 999 999 999 999 999 999
999 999 999 999 999 999 999 999 999 999 999 999 999 999 999 999 999 999 999 999 999 999 999 999 999 999 999 999 999 999 999 999 999 999 999 999 999 999 999 999 999 999 999 999 999 999 999 999 999 999 999 999 999 999 999 999 999 999 999 999 999 999 999 999 999 999 999 999 999 999


