10 10 10 10 10 10 10 10 10 10 10 10 10 10 10 10 10 10 10 10 10 10 10 10 10 10 10 10 10 10
10 10 10 10 10 10 10 10 10 10 10 10 10 10 10 10 10 10 10 10 10 10 10 10 10 10 10 10 10 10
10 10 10 10 10 10 10 10 10 10 10 10 10 10 10 10 10 10 10 10 10 10 10 10 10 10 10 10 10 10
10 10 10 10 10 10 10 10 10 10 10 10 10 10 10 10 10 10 10 10 10 10 10 10 10 10 10 10 10 10
10 10 10 10 10 10 10 10 10 10 10 10 10 10 10 10 10 10 10 10 10 10 10 10 10 10 10 10 10 10
10 10 10 10 10 10 10 10 10 10 10 10 10 10 10 10 10 10 10 10 10 10 10 10 10 10 10 10 10 10
10 10 10 10 10 10 10 17 11 11 11 11 11 11 11 11 11 11 11 11 11 11 18 10 10 10 10 10 10 10
10 10 10 10 10 10 17 40 12 12 12 12 12 12 30 32 31 33 30 31 32 33 41 18 10 10 10 10 10 10
10 10 10 10 10 10 22 12 12 12 12 12 12 12 34 29 29 39 34 29 29 39 12 21 10 10 10 10 10 10
10 10 10 10 10 10 22 12 12 12 12 12 12 12 34 29 29 39 34 29 29 39 12 21 10 10 10 10 10 10
10 10 10 10 10 10 22 27 11 11 11 28 12 12 34 29 29 39 34 29 29 39 12 21 10 10 10 10 10 10
10 10 10 10 10 10 22 45 12 12 12 24 12 12 34 29 29 39 34 29 29 39 12 21 10 10 10 10 10 10
10 10 10 10 10 10 22 45 12 12 12 24 12 12 35 36 37 38 35 37 36 38 12 21 10 10 10 10 10 10
10 10 10 10 10 10 22 45 12 12 12 24 12 12 30 31 32 33 30 32 31 33 12 21 10 10 10 10 10 10
10 10 10 10 10 10 22 45 12 12 12 24 12 12 34 29 29 39 34 29 29 39 12 21 10 10 10 10 10 10
10 10 10 10 10 10 22 26 13 14 15 25 12 12 34 29 29 39 34 29 29 39 12 21 10 10 10 10 10 10
10 10 10 10 10 10 22 12 12 43 16 12 12 12 34 29 29 39 34 29 29 39 12 21 10 10 10 10 10 10
10 10 10 10 10 10 19 20 12 12 12 12 12 12 34 29 29 39 34 29 29 39 12 21 10 10 10 10 10 10
10 10 10 10 10 10 10 19 23 23 23 23 23 20 35 37 36 38 35 36 37 38 12 21 10 10 10 10 10 10
10 10 10 10 10 10 10 10 10 10 10 10 10 19 20 12 12 12 12 12 12 12 44 42 10 10 10 10 10 10
10 10 10 10 10 10 10 10 10 10 10 10 10 10 19 23 23 23 23 23 23 23 42 10 10 10 10 10 10 10
10 10 10 10 10 10 10 10 10 10 10 10 10 10 10 10 10 10 10 10 10 10 10 10 10 10 10 10 10 10
10 10 10 10 10 10 10 10 10 10 10 10 10 10 10 10 10 10 10 10 10 10 10 10 10 10 10 10 10 10
10 10 10 10 10 10 10 10 10 10 10 10 10 10 10 10 10 10 10 10 10 10 10 10 10 10 10 10 10 10
10 10 10 10 10 10 10 10 10 10 10 10 10 10 10 10 10 10 10 10 10 10 10 10 10 10 10 10 10 10
10 10 10 10 10 10 10 10 10 10 10 10 10 10 10 10 10 10 10 10 10 10 10 10 10 10 10 10 10 10
10 10 10 10 10 10 10 10 10 10 10 10 10 10 10 10 10 10 10 10 10 10 10 10 10 10 10 10 10 10
10 10 10 10 10 10 10 10 10 10 10 10 10 10 10 10 10 10 10 10 10 10 10 10 10 10 10 10 10 10
10 10 10 10 10 10 10 10 10 10 10 10 10 10 10 10 10 10 10 10 10 10 10 10 10 10 10 10 10 10
10 10 10 10 10 10 10 10 10 10 10 10 10 10 10 10 10 10 10 10 10 10 10 10 10 10 10 10 10 10